%%%%%%%%%%%%%%%%%%%%
%    %     .  %    %
% %% % %%%%%% % %% %
% %              % %
% % %% %%  %% %% % %
%  .   %    %      %
% % %% %%%%%% %% % %
% %    .         % %
% %% % %%%%%% % %% %
%    %   P    % .  %
%%%%%%%%%%%%%%%%%%%%
